--------------------------------------------------
|                                                |
|                                                |
|                                                |
|                   ____________                 |
|   ()             /________|____\___            |
|  /||\           |                  |           |
|   /\            --- @ ------ @ ----            |
--------------------------------------------------
Get to the treasure chest...
